F 76,76,76
C 99,99,99
NO ./textures/north.xpm
SO ./textures/south.xpm
WE ./textures/west.xpm
EA ./textures/east.xpm
1111111111111111111
0000000000000000000
1011000001000001001
1001001001111101111
1001111000001001001
1000000000000001001
1001111111111001001
1111000000000001011
10000000000000000W1
1111111111111111111

