NO textures/NORTH.xpm
SO textures/SOUTH.xpm
WE textures/WEST.xpm
EA textures/EAST.xpm

F 123,20,255
C 153,204,100

1111111111111111111111111111111111111111111111111111111111111111111
100000EH00000000000000000000000000000011111000000000000000000000001
1000000100000000000000000000000000000011111000000000000000000000001
1000000H00000000000000000000000000000000001000000000000000000000001
1111111100001000000000000000000000000000001000000000000010000000001
1000000000000000000000000000000000100000001000000000000000000000001
1000000000000000000000000000000000000000001000000000000000000000001
1000000000000000000000000000000000000000001000000000000000000000001
1000000000000000000000000000000000000000001000111111000000000000001
1000000000000000000000000000000000000000001000000000000000000000001
1000000000000000010000000000000000000000001000000000000000000000001
1000000000000000000100000000000000000000001000000000000000000000001
1000000000000000000000000000000000000000000000000000000000000001111
1111111111111111111111111111111111111111111111111111111111111
