NO ./textures/north.xpm
                    SO ./textures/south.xpm
           WE ./textures/west.xpm
EA                               ./textures/east.xpm

F                  153,                0,153
               C                178,102,255

11111111
10000001   11111
10000001  100001    
10000001   11001
100000001111100111111
100000000000000000001
100000000 00000000001         1
1000000000000000000001       101
 1000000001110000000001     10001
  1000000000000000000001   1000001
   100000000   0100000001 100000001
    1000000  W 00000000 01 000000001
    10000000   111100000 000000000001
    100 00000011   1000011100000000001
    1000000001     11111110000000011
    111111111             100000011
                           1100001
                             1001
                              11

















1111111111111111111
1000000000000000001
1111111111111111111
























