NO ./textures/north.xpm
                    SO ./textures/south.xpm
           WE ./textures/west.xpm
EA	./textures/east.xpm
EA	./textures/east.xpm
F                  103, 45, 150
C                90, 63, 171
11111111
10000001   11111
10000001  100001    
10000001   11001
100000001111100 11111
100000000000000000001
100000000000000000001         1
1000000000000000000001       101
 1000000001110000000001     10001
  1000000000000000000001   1000001
   100000000   0100000001 100000001
    1000000  N 00000000 01 000000001
    10000000   111100000 000000000001
    100 00000011   1000011100000000001
    1000000001     111111100000000111
    111111111             100000011
                           1100001
                             1001
                              101
                              111
1111111111111111111
1000000000000000001
1111111111111111111
