NO textures/dsa.xpm


C 153,204,100







WE textures/dsa.xpm












F 123,20,258




SO textures/dsa.xpm

EA textures/dsa.xpm

  1111111111111111111111111		
  1000000000110000000000001
  1011000001110000000000001
  1001000000000000000000001       000000000000000000000000000000000000000000000011111111111111111111111111111111111111
1111111111111111101100000011111111111111111111111111111111111111111111111111111111111111000000000000000000000000000111
1000000000110000011101111111111110000000000000000000000000000000000000000000000000000000000000000000000000000000000001
11110111111111011100000010000000000R0000000000000000000000000000000000000000000000000000000000000000000000000000000001
1111011111111101110101000000111111111111111111111111111111111111111111111111111111111111111111111111111111111111111111
11000000110101011100000010001
10000000000000001100000010001
10000000000000001101010010001
11000001110101011111011110N0111
11110111 1110101 101111010001
11111111 11111011111111111111
00000000000000 
