F 76,76,76
C 99,99,255

NO north.xpm
SO south.xpm
WE west.xpm


1111111111111111111
10E1001001001000001
1011000001000001001
1001001001111101111
1001111000001001001
1000000000000001001
1001111111111001001
111100000000000101111111111111111
100000000100000000000000000000001
111111111111111111111111111111111

EA east.xpm
