F 76,76,76
C 99,99,255

NO 
SO south.xpm
WE west.xpm
EA east.xpm

1111111111111111111
10E1001001001000001
1011000001000001001
1001001001111101111
1001111000001001001
1000000000000001001
10011111111110010000000000000
1111000000000001011
1000000001000000001
1111111111111111111

