NO textures/dsa.xpm
SO textures/dsa.xpm
WE textures/dsa.xpm
EA textures/dsa.xpm

F 123,20,123
C 153,204,010

1111111111111111111
10E1001001001000001
1011000001000001001
1001001001111101111
1001111000001001001
1000000000000001001
1001111111111001001
111100000000000101111111111111111
1000000001000000000000000000000 1
111111111111111111111111111111111
